********
*      *
*  *   *
*  *   *
********
